1111111111111111
1000E00000000001
1X1001010X100001
1010010010101011
1P000000XC00C001
1111111111111111