1111111111111111
1000X000000000C1
1E10000110X0X001
11X10X0010100111
1P0001XCX0C100C1
1111111111111111